access	Set access level on published packages
add	Install a package
adduser	Add a registry user account
apihelp	Get help on npm
audit	Run a security audit
author	Manage package owners
bin	Display npm bin folder
bugs	Bugs for a package in a web browser maybe
c	Manage the npm configuration files
cache	Manipulates packages cache
ci	Install a project with a clean slate
cit	Runs an npm ci followed immediately by an npm test.
clean-install	Install a project with a clean slate
clean-install-test	Run an npm ci followed immediately by an npm test
completion	Tab Completion for npm
config	Manage the npm configuration files
create	create a package.json file
ddp	Reduce duplication
dedupe	Reduce duplication
deprecate	Deprecate a version of a package
dist-tag	Modify package distribution tags
docs	Docs for a package in a web browser maybe
doctor	Check your environments
edit	Edit an installed package
explore	Browse an installed package
find	Search for packages
find-dupes	Reduce duplication
fund	Retrieve funding information
get	npm config get
help	Get help on npm
help-search	Search npm help documentation
home	Docs for a package in a web browser maybe
hook	Manage registry hooks
i	Install a package
ic	Install a project with a clean slate
info	View registry info
init	create a package.json file
install	Install a package
install-ci-test	Run an npm ci followed immediately by an npm test
install-clean	Install a project with a clean slate
install-test	Run an npm install followed immediately by an npm test
issues	Bugs for a package in a web browser maybe
it	Run an npm install followed immediately by an npm test
la	List installed packages
link	Symlink a package folder
list	List installed packages
ll	List installed packages
ln	Symlink a package folder
login	Add a registry user account
logout	Log out of the registry
ls	List installed packages
org	Manage orgs
outdated	Check for outdated packages
owner	Manage package owners
pack	Create a tarball from a package
ping	Ping npm registry
prefix	Display prefix
profile	Change settings on your registry profile
prune	Remove extraneous packages
publish	Publish a package
r	Remove a package
rb	Rebuild a package
rebuild	Rebuild a package
remove	Remove a package
repo	Open package repository page in the browser
restart	Restart a package
rm	Remove a package
root	Display npm root
run	Run arbitrary package scripts
run-script	Run arbitrary package scripts
s	Search for packages
se	Search for packages
search	Search for packages
set	npm config set
show	View registry info
shrinkwrap	Lock down dependency versions for publication
star	Mark your favorite packages
stars	View packages marked as favorites
start	Start a package
stop	Stop a package
t	Test a package
team	Manage organization teams and team memberships
test	Test a package
token	Manage your authentication tokens
tst	Test a package
udpate	Update a package
un	Remove a package
uninstall	Remove a package
unlink	Remove a package
unpublish	Remove a package from the registry
unstar	Mark your favorite packages
up	Update a package
update	Update a package
upgrade	Update a package
v	View registry info
version	Bump a package version
view	View registry info
whoami	Display npm username
